Level 2
8 8
++++++++
+a  bbb+
+a  c d+
+** ced@
+fff ed+
+  g jj+
+hhgii +
++++++++