Level 1
8 8
++++++++
+aabbbc+
+   * c+
+d  *  +
+d fff +
+de    +
+ e ggg+
++++@+++
