Level 3
6 6
++++++++
+      +
+aab*  +
+c b*  +
+cddd  +
+      +
+eee   +
++++@+++