Level 1
8 8
++++++++
+      +
+aab*  +
+c b*  +
+cddd  +
+      @
+eee   +
++++@+++